20 20
3 4
0 0 0 0 0 0 0 0 0 0 0 0 0 0 0 0 0 0 0 0
0 3 3 2 2 4 4 4 4 4 4 4 4 4 4 4 4 4 4 0
0 2 1 1 1 4 4 4 4 4 4 4 4 4 4 4 4 4 4 0
0 1 1 0 4 4 4 4 4 4 4 4 4 4 4 4 4 4 4 0
0 1 4 4 4 4 4 4 4 4 4 4 4 4 4 4 4 4 4 0
0 4 4 4 4 4 4 4 4 4 4 4 4 4 4 4 4 4 4 0
0 1 1 1 1 4 4 4 4 4 4 4 4 4 4 4 4 4 4 0
0 1 1 1 1 4 4 4 4 4 4 4 4 4 4 4 4 4 4 0
0 1 1 1 1 4 4 4 4 4 4 4 4 4 4 4 4 4 4 0
0 1 1 1 1 4 4 4 4 4 4 4 4 4 4 4 4 4 4 0
0 1 1 1 1 4 4 4 4 4 4 4 4 4 4 4 4 4 4 0
0 1 1 1 1 4 4 4 4 4 4 4 4 4 4 4 4 4 4 0
0 1 1 1 1 4 4 4 4 4 4 4 4 4 4 4 4 4 4 0
0 1 1 1 1 4 4 4 4 4 4 4 4 4 4 4 4 4 4 0
0 1 1 1 1 4 4 4 4 4 4 4 4 4 4 4 4 4 4 0
0 1 1 1 1 4 4 4 4 4 4 4 4 4 4 4 4 4 4 0
0 1 1 1 1 4 4 4 4 4 4 4 4 4 4 4 4 4 4 0
0 1 1 1 1 4 4 4 4 4 4 4 4 4 4 4 4 4 4 0
0 1 1 1 1 4 4 4 4 4 4 4 4 4 4 4 4 4 4 0
0 0 0 0 0 0 0 0 0 0 0 0 0 0 0 0 0 0 0 0
