20 20
3 4
0 1 2 3 4 4 4 4 4 4 4 4 4 4 4 4 4 4 4 4
2 3 3 2 2 4 4 4 4 4 4 4 4 4 4 4 4 4 4 4
2 2 1 1 1 4 4 4 4 4 4 4 4 4 4 4 4 4 4 4
1 1 1 0 4 4 4 4 4 4 4 4 4 4 4 4 4 4 4 4
1 1 4 4 4 4 4 4 4 4 4 4 4 4 4 4 4 4 4 4
4 4 4 4 4 4 4 4 4 4 4 4 4 4 4 4 4 4 4 4
1 1 1 1 1 4 4 4 4 4 4 4 4 4 4 4 4 4 4 4
1 1 1 1 1 4 4 4 4 4 4 4 4 4 4 4 4 4 4 4
1 1 1 1 1 4 4 4 4 4 4 4 4 4 4 4 4 4 4 4
1 1 1 1 1 4 4 4 4 4 4 4 4 4 4 4 4 4 4 4
1 1 1 1 1 4 4 4 4 4 4 4 4 4 4 4 4 4 4 4
1 1 1 1 1 4 4 4 4 4 4 4 4 4 4 4 4 4 4 4
1 1 1 1 1 4 4 4 4 4 4 4 4 4 4 4 4 4 4 4
1 1 1 1 1 4 4 4 4 4 4 4 4 4 4 4 4 4 4 4
1 1 1 1 1 4 4 4 4 4 4 4 4 4 4 4 4 4 4 4
1 1 1 1 1 4 4 4 4 4 4 4 4 4 4 4 4 4 4 4
1 1 1 1 1 4 4 4 4 4 4 4 4 4 4 4 4 4 4 4
1 1 1 1 1 4 4 4 4 4 4 4 4 4 4 4 4 4 4 4
1 1 1 1 1 4 4 4 4 4 4 4 4 4 4 4 4 4 4 4
1 1 1 1 1 4 4 4 4 4 4 4 4 4 4 4 4 4 4 4
1 1 1 1 1 4 4 4 4 4 4 4 4 4 4 4 4 4 4 4