5 7
3 4
0 0 0 0 0
2 3 3 2 2
2 2 1 1 1
1 1 1 0 4
1 1 4 4 4
4 4 4 4 4
1 1 1 1 1